Ringmaster Outfit: Tailcoat-inspired Corset Dress, Mini Top Hat, Bullwhip, Lace-up Boots
Trapeze Artist Outfit: Sequined Leotard, Tights, Flying Boots, Chalk Bag
Strongwoman Outfit: Leotard with Muscle Design, Weightlifting Belt, Dumbbell, Bold Makeup
Tightrope Walker Outfit: Sparkly Bodysuit, Sequined Sash, Balancing Pole, Ballet Slippers
Clown Outfit: Ruffled Dress, Striped Stockings, Oversized Shoes, Face Paint
Fortune Teller Outfit: Flowing Skirt with Scarves, Crystal Ball, Headscarf, Bangle Bracelets
Magician Outfit: Corseted Dress with Cape, Top Hat, Magic Wand, Fishnet Stockings
Contortionist Outfit: Leotard with Stretch Fabric, Leg Warmers, Barefoot
Juggler Outfit: Patterned Dress, Juggling Rings, Bowler Hat, Wacky Accessories
Assistant Outfit: Silky Blouse with Puffy Sleeves, Sash Belt, Tarot Cards, Veiled Hat
Acrobat Outfit: Matching Leotard, Partner Balancing Tricks, Gymnastics Shoes
Fire Eater Outfit: Flaming Outfit, Fire-Eating Props, Fire-Resistant Gloves
Animal Trainer Outfit: Corset with Animal Accessories, Hat, Whip, Boots
Barker Outfit: Sparkly Dress with Fringe, Megaphone, Feathered Headband, Fishnet Stockings
Musician Outfit: Flared Skirt with Musical Notes, Bowtie, Musical Instrument, Hair Bow
Classic Clown Outfit: Ruffled Dress, Striped Stockings, Oversized Shoes, Face Paint, Colorful Wig, Clown Hat
Mime Clown Outfit: Striped Dress, White Gloves, Beret, Face Paint, Striped Tights
Jester Clown Outfit: Ruffled Jester Dress, Jester Hat with Bells, Face Paint, Tights
Sad Clown Outfit: Tattered Dress, Oversized Shoes, Teardrop Makeup, Droopy Hat, Oversized Flower
Elegant Clown Outfit: Gown with Colorful Accents, Mini Top Hat, Gloves, Sparkly Accessories
Punk Clown Outfit: Torn Skirt, Leather Jacket with Patches, Mohawk, Fishnet Stockings, Combat Boots
Steampunk Clown Outfit: Corseted Dress with Gears, Mini Top Hat with Goggles, Garter Belt, Fingerless Gloves
Candyland Clown Outfit: Tutu with Candy Accents, Oversized Candy Props, Candy Crown, Bright Makeup
Cartoon Clown Outfit: Oversized Dress, Comically Large Shoes, Cartoon Eyes Makeup, Funky Hair Accessories
Animal Clown Outfit: Animal-themed Dress, Animal Face Paint, Furry Ears Headband, Paw Gloves, Tail
Illusionist Outfit: Glamorous Gown with Hidden Compartments, Feathered Top Hat, Magic Wand, Crystal Necklace
Street Magician Outfit: Tailored Jacket with Rolled-Up Sleeves, Fedora Hat, Coin Tricks, Leather Bracelets
Enchanter Outfit: Flowing Gown with Draping Sleeves, Crystal Crown, Wand, Amulet Necklace
Escapist Outfit: Striped Corseted Dress, Chain Accessories, Shackles, Locked Chest
Paranormal Magician Outfit: Victorian-inspired Dress, Lace Veil, Tarot Cards, Crystal Ball, Ankh Necklace
Aerial Acrobat Outfit: Sparkly Leotard, Aerial Silks Accessories, Chalk Bag, Barefoot
Human Cannonball Outfit: Metallic Jumpsuit with Attached Harness, Helmet with Goggles, Boots
Hoop Acrobat Outfit: Sequined Leotard, Hoop Prop, Chalk Bag, Ballet Slippers
Balance Acrobat Outfit: Vibrant Leotard, Balance Board, Wrist Straps, Barefoot
Clown Acrobat Outfit: Polka-dot Leotard, Clown Accessories, Face Paint, Oversized Shoes
Hula Hoop Acrobat Outfit: Colorful Leotard, Hula Hoop Tricks, Wristbands, Sneakers
Trampoline Acrobat Outfit: Athletic Top and Shorts, Trampoline Jumps, Headband, Athletic Shoes
Ribbon Dancer Acrobat Outfit: Elegant Leotard with Ribbons, Dance Shoes, Ribbon Hairpiece
Haunted Ringmaster Outfit: Decayed Dress with Ruffles, Torn Top Hat, Blood-red Lips, Ghostly Makeup
Sinister Clown Outfit: Ragged Dress, Distorted Clown Mask, Blood-stained Gloves, Choker
Possessed Acrobat Outfit: Torn Leotard, Haunting Makeup, Chain Accessory, Blood-smeared Hands
Undead Strongwoman Outfit: Shredded Leotard, Rotting Flesh Makeup, Broken Chains, Tattered Boots
Wicked Magician Outfit: Corseted Gown with Dark Accents, Ominous Makeup, Blood-smeared Hands, Crystal Ball
Haunting Contortionist Outfit: Ripped Leotard, Pale Makeup, Distorted Poses, Barefoot
Possessed Jester Outfit: Shredded Ruffled Dress, Distorted Makeup, Blood-smeared Gloves, Haunting Laughter
Nightmarish Puppeteer Outfit: Decayed Gown, Puppeteer Threads, Hollow Eyes Makeup, Grinning Puppet Face
Cursed Barker Outfit: Ripped Dress, Hollow Eyes Makeup, Crooked Smile, Echoing Laughter
Haunted Fortune Teller Outfit: Tattered Gown, Veiled Hat, Cursed Tarot Cards, Eerie Aura
Malevolent Trainer Outfit: Torn Corset, Fiery Eyes Makeup, Fanged Grin, Chains and Collar
Creepy Fire Eater Outfit: Scorched Dress, Fiery Makeup, Glowing Eyes, Fiendish Horns