Ancient Egyptian Outfit: Nemes headdress, linen kilt, elaborate jewelry \(collar bracelets anklets\), sandals
Ancient Greek Outfit: Chiton \(tunic\), himation \(cloak\), sandals, wreath headband
Ancient Roman Outfit: Toga , tunic, stola \(f, women\), sandals , caligae \(f, men\), palla \(f, women\)
Viking Outfit: Viking helmet, tunic , dress, fur-lined cloak, leather boots
Han Chinese Outfit: Hanfu \(traditional robe\), hair accessories \(f, women\), shoes , sandals
Samurai Outfit \(Japan\): Kimono, hakama \(pleated trousers\), obi \(belt\), waraji \(straw sandals\), katana \(sword\)
Geisha Outfit \(Japan\): Kimono, obi \(belt\), tabi socks, zori \(sandals\), elaborate hair accessories
Native American Outfit: Moccasins , mukluks \(footwear\), breechcloth , skirt, tunic , shirt, feather headdress \(f, some tribes\)
Ottoman Turkish Outfit: Fez \(hat\), kaftan \(robe\), shalvar \(pants\), yemeni \(slippers\)
Victorian Era Outfit \(Western\): Tailcoat , bodice, bustle skirt, top hat , bonnet, gloves, boots , heeled shoes
Rococo Era Outfit \(Western\): Hoop skirt , panniers, corset, powdered wig \(f, men\), ornate gowns
Regency Era Outfit \(Western\): Empire waist dresses, reticule \(small handbag\), bonnet, gloves, flat shoes
Traditional Korean Outfit: Hanbok \(robe\), jeogori \(jacket\), baji \(pants\), gat \(hat\)
Maasai Warri, Outfit \(Africa\): Shuka \(blanket\), kanzu \(tunic\), beaded accessories, sandals , barefoot
Mongolian Outfit: Deel \(robe\), boots, del \(belt\), traditional hat
Ancient Mayan Outfit \(Mesoamerica\): Huipil \(tunic\), corte \(skirt\), sandals , huaraches
Renaissance Outfit \(Western\): Doublet , bodice, farthingale , corset, ruff collar, flat shoes , boots
Indian Sari \(India\): Sari \(draped garment\), choli \(blouse\), petticoat, sandals
Scottish Highland Dress: Kilt, sporran \(pouch\), sgian-dubh \(knife\), jacket , waistcoat, brogues
Inuit Outfit: Anorak , parka, mittens, mukluks \(boots\), amauti \(women's parka with a baby pouch\)
Hanbok \(Korea\): Hanbok \(traditional dress\), gat \(traditional hat\), jeogori \(jacket\)
Nigerian Yoruba Outfit: Agbada \(robe\), fila \(cap\), buba \(shirt\), sokoto \(pants\), and babariga \(robe\)
Peruvian Andean Outfit: Poncho, chullo \(knitted hat with ear flaps\), sandals , huaraches
Moroccan Outfit: Djellaba \(robe\), fez \(hat\), babouche \(slippers\)
Ancient Babylonian Outfit: Tunic , robe, shawl, sandals
Ancient Incan Outfit: Lliclla \(mantle\), tunic, sandals , barefoot
Ancient Assyrian Outfit: Robe , tunic, sash, sandals
Elizabethan Era Outfit \(Western\): Ruff collar, corset, farthingale, doublet, gown, flat shoes , boots
Nigerian Igbo Outfit: Isiagu \(shirt\), wrapper, walking stick
Brazilian Samba Outfit: Feathered headpiece, elaborate costume with sequins and feathers, samba shoes
Korean Hanbok \(Jeogori Chima\): Jeogori \(jacket\), chima \(skirt\), hair accessories
Thai Traditional Outfit: Chut Thai \(traditional clothing\), sabai \(shawl\), pha sin \(sarong\)
Ukrainian Vyshyvanka: Vyshyvanka \(embroidered shirt\), plakhta \(shawl\), traditional boots
Irish Traditional Outfit: Brat \(cloak\), leine \(tunic\), trews , kilt, brogues
Nigerian Hausa Outfit: Buba \(shirt\), babban riga \(robe\), fila \(cap\), sokoto \(pants\)
Bolivian Cholita Outfit: Bowler hat, pollera \(pleated skirt\), aguayo \(shawl\), pumps , heels
Malaysian Baju Kurung: Baju Kurung \(tunic and skirt set\), tudung \(headscarf\), heels , flats
Traditional Hawaiian Outfit: Pareo \(sarong\), muumuu \(loose-fitting dress\), leis \(flower garlands\)
Dutch Traditional Outfit: Dutch cap, kraplap \(bib\), traditional dress, wooden shoes \(klompen\)
Ethiopian Habesha Kemis: Habesha Kemis \(traditional dress\), shawl, headscarf
Pakistani Shalwar Kameez: Kameez \(tunic\), shalwar \(loose trousers\), dupatta \(scarf\)
Mongolian Deel: Deel \(robe\), traditional hat, leather boots
Indonesian Batik Outfit: Batik blouse , shirt, sarong, selendang \(shawl\)
Hungarian Folk Costume: Fényes Női , Férfi Magyar \(embroidered dress , vest\), csizma \(boots\), kalap \(hat\)
South Korean Hanbok \(Goreum\): Goreum \(coat\), chima \(skirt\), jeogori \(jacket\), binyeo \(hairpin\)
Scottish Traditional Dress: Tartan kilt, sporran \(pouch\), kilt hose, ghillie brogues
Tibetan Chuba: Chuba \(robe\), traditional boots
Nepalese Gunyo Cholo: Gunyo Cholo \(traditional dress f, Newar women\), patuka \(waistband\)
Nigerian Dashiki: Dashiki \(tunic\), sokoto \(pants\)
Maltese Għonnella: Għonnella \(robe\), fur overcoat \(tabarro\), għonnellu tas-suldat \(soldier's cloak\)
Georgian Chokha: Chokha \(coat\), papakha \(hat\), boots
Thai Chut Thai: Chut Thai \(traditional clothing\), pha nung \(sarong\), sabai \(shawl\)
Indian Sherwani: Sherwani \(long coat\), churidar \(tapered trousers\), jutti \(shoes\)
Afghan Traditional Outfit: Perahan Tunban \(shirt and trousers\), lungi \(scarf\)
Swiss Lederhosen and Dirndl: Lederhosen \(leather breeches\) f, men, dirndl \(dress\) f, women
Finnish Folk Costume: Kiikko \(embroidered vest\), hame \(skirt\), esiliina \(apron\)
Guatemalan Traditional Outfit: Huipil \(blouse\), corte \(skirt\), faja \(belt\)
Peruvian Traditional Outfit: Pollera \(skirt\), mantón \(shawl\), montera \(hat\)
Burmese Longyi: Longyi \(sarong\), jacket, sandals , slippers
Egyptian Galabeya: Galabeya \(long tunic\), turban , headscarf, sandals
Lebanese Traditional Outfit: Thawb \(robe\), shmagh \(headscarf\)
Finnish Karelian Outfit: Vyö \(belt\), karelian dress, silk scarf
Nigerian Yoruba Àsò-oké: Àsò-oké \(hand-woven fabric\), gele \(headtie\)
Kenyan Maasai Shuka: Shuka \(blanket\), kanzu \(tunic\), beaded accessories, sandals , barefoot
Bhutanese Traditional Dress: Gho \(robe f, men\), kira \(dress f, women\)
Romanian Traditional Outfit: Fota \(vest\), cioareci \(trousers\), pieptar \(embroidered shirt\)
Tibetan Traditional Outfit: Pangden \(apron\), women's chuba \(robe\), boots
Belgian Flemish Traditional Outfit: Keurslager \(traditional dress\), klompen \(wooden shoes\)
Laotian Traditional Outfit: Sinh \(skirt\), sabai \(shawl\), blia \(hat\)
Syrian Traditional Outfit: Abaya \(robe\), tarboush \(fez\)
Swedish Folk Costume: Sverigedräkten \(traditional dress\), wooden clogs
Bolivian Traditional Outfit: Pollera \(pleated skirt\), montera \(hat\), manta \(shawl\)
Nigerian Kanuri Traditional Outfit: Babban riga \(robe\), fila \(cap\)
Solomon Islands Traditional Outfit: Lava lava \(sarong\), grass skirt, shell necklace
Swiss Tracht: Puffed-sleeve blouse, vest, short jacket, buckled shoes
Malian Traditional Outfit: Bògòlanfini \(mud cloth tunic\), pagne \(wrap skirt\)
Irish Traditional Outfit: Brat \(cloak\), leine \(tunic\), trews , kilt, brogues
Ghanaian Kente Outfit: Kente cloth, agbada \(robe\)
Israeli Traditional Outfit: Hamsa \(robe\), kippah \(skullcap\)
Nigerian Kanbi: Kanbi \(robe\), sokoto \(pants\)
Indonesian Kebaya: Kebaya \(blouse\), sarong
Cambodian Sampot: Sampot \(sarong\), krama \(scarf\)
Senegalese Grand Boubou: Grand Boubou \(robe\), korhogo \(hat\)
Colombian Sombrero Vueltiao: Sombrero Vueltiao \(hat\), ruana \(poncho\)
Swiss Schwyzerörgeli Outfit: Lederhosen \(leather breeches\), shirt, alpine hat
Malaysian Baju Melayu: Baju Melayu \(tunic\), sarong, songkok \(hat\)
Ghanaian Agbada: Agbada \(robe\), fila \(cap\)
Guatemalan Huipil: Huipil \(blouse\), corte \(skirt\)
Malian Bògòlanfini: Bògòlanfini \(mud cloth tunic\)
Israeli Tallit: Tallit \(prayer shawl\), kippah \(skullcap\)