Elizabethan Court Poet outfit: doublet jacket, ruffled collar, slashed velvet breeches, silk stockings, leather shoes, feathered cap
Ancient Greek Philosopher outfit: himation cloak, chiton tunic, leather sandals, bronze fibula brooch, braided belt
Persian Magi outfit: long embroidered kandys cloak, belted tunic, soft leather boots, beaded headdress, golden bracelets
Arab Abbasid Vizier outfit: silk caftan robe, golden sash, embroidered turban, leather slippers, jeweled ring
Medieval French Troubadour outfit: woolen cotehardie tunic, belted surcoat, feathered hat, leather pouch, soft boots, lute
Venetian Renaissance Merchant outfit: fur-lined robe, silk doublet, embroidered hose, velvet hat, gold chain, leather shoes
Ming Dynasty Scholar outfit: flowing silk changshan robe, black gauze putou cap, wooden scroll case, jade belt ornament, cloth shoes
Byzantine Court Eunuch outfit: long silk divetesion robe, gilded epimanikia cuffs, bejeweled belt, embroidered slippers, pearl-studded cap
Late Ottoman Pasha outfit: brocade kaftan robe, tall kavuk turban, golden sash, silk trousers, curved dagger, leather slippers
Russian Boyar outfit: fur-trimmed kaftan coat, tall kolpak hat, brocaded belt, silk boots, bejeweled dagger, golden ring
Japanese Heian Noble outfit: layered sokutai robes, lacquered eboshi hat, golden sash, wooden geta sandals, folding fan
Napoleonic Diplomat outfit: embroidered frock coat, cravat necktie, silk waistcoat, knee-length breeches, leather dress shoes, powdered wig
Austro-Hungarian Courtier outfit: military-style dolman jacket, silk cravat, gold-embroidered waistcoat, tight breeches, knee-high boots, sash
Sumerian High Priest outfit: fringed linen kaunakes robe, wide beaded collar, golden armband, leather sandals, conical cap
Mughal Courtier outfit: brocade sherwani coat, silk churidar trousers, jewel-studded turban, bejeweled dagger, embroidered slippers
Carolingian Scribe outfit: woolen tunic, leather belt, fur-trimmed cloak, wooden writing tablet, bronze brooch, soft boots
Gothic Burgundian Courtier outfit: long houppelande robe, high-collared chaperon hood, jeweled belt, pointed poulaines shoes, golden chain
Victorian Gentleman outfit: frock coat, waistcoat, high-collared shirt, cravat tie, top hat, polished leather shoes, walking cane
Moorish Andalusian Vizier outfit: embroidered djellaba robe, white turban, silk sash, curved dagger, leather slippers
Aztec High Priest outfit: feathered quetzal headdress, jaguar pelt cloak, beaded loincloth, gold ear spools, obsidian scepter
Baroque Spanish Grandee outfit: black doublet, ruffled golilla collar, silk cape, knee-high boots, feathered hat, jeweled brooch
Georgian Era Courtier outfit: brocade justaucorps coat, lace jabot cravat, knee-length breeches, silk stockings, powdered wig, buckled shoes
Imperial Roman Patrician outfit: white-bordered toga, crimson tunic, leather calcei boots, golden signet ring, laurel wreath
French Rococo Aristocrat outfit: pastel silk frock coat, lace-trimmed waistcoat, powdered wig, embroidered breeches, silk stockings, silver-buckled shoes
Hawaiian Ali‘i Nobleman outfit: feathered ‘ahu‘ula cape, malo loincloth, kukui nut necklace, wooden lei niho palaoa pendant, woven sandals
Florentine Renaissance Banker outfit: long velvet giornea robe, silk doublet, red wool cap, gold chain, leather shoes
Edwardian Dandy outfit: striped morning coat, wing-collared shirt, silk cravat, waistcoat, spats-covered shoes, bowler hat
Dahomey Court Official outfit: richly embroidered tunic, beaded necklaces, woven raffia sandals, ceremonial staff, feathered headdress
Ming Dynasty Magistrate outfit: long silk robe, black gauze hat, jade belt, embroidered slippers, carved ivory fan
German Baroque Composer outfit: dark velvet coat, lace jabot cravat, powdered periwig, knee-length breeches, silk stockings, buckled shoes
Medieval English Lord outfit: woolen tunic, embroidered surcoat, fur-lined cloak, golden chain, leather shoes
Ottoman Janissary Agha outfit: silk kaftan, plumed mücevveze hat, jeweled belt, curved yatagan sword, embroidered slippers
Muscovite Nobleman outfit: fur-lined kaftan, high collar, golden belt, silk boots, large golden cross pendant
Tudor Court Jester outfit: brightly colored motley tunic, belled fool’s cap, striped hose, soft slippers, wooden scepter
Arab Umayyad Scholar outfit: woolen thobe robe, white keffiyeh headscarf, leather sandals, beaded prayer beads, ink-stained fingers
French Bourbon Courtier outfit: silk justaucorps coat, lace cravat, golden waistcoat, silk breeches, red-heeled shoes
Korean Joseon Yangban outfit: dark silk durumagi overcoat, gat horsehair hat, wooden belt ornament, leather shoes, scroll case
Safavid Persian Nobleman outfit: brocade qaba robe, silk trousers, jewel-studded turban, curved dagger, embroidered slippers
Imperial Chinese Eunuch outfit: embroidered long robe, round mandarin hat, wide jade belt, wooden writing tablet
Edo Period Kabuki Actor outfit: elaborate kimono, padded obi belt, lacquered geta sandals, painted face, ceremonial fan
Caribbean Buccaneer Captain outfit: wide-brimmed hat, embroidered waistcoat, leather cutlass belt, knee-high boots, gold hoop earring
Italian Baroque Cardinal outfit: crimson silk cassock, white lace rochet, biretta cap, golden pectoral cross, leather slippers
Mayan High Priest outfit: jade-studded headdress, feathered cape, embroidered loincloth, golden armlets, obsidian scepter
Victorian Theatrical Actor outfit: embroidered frock coat, lace cuffs, silk cravat, polished dress shoes, top hat
Polish Szlachta Nobleman outfit: crimson kontusz robe, fur-trimmed zupan tunic, sabretache pouch, leather riding boots
Sikh Maharaja outfit: jewel-encrusted turban, brocade achkan coat, silk churidar trousers, pearl necklaces, gold-embroidered slippers
Dutch Golden Age Merchant outfit: black doublet, wide-brimmed hat, lace collar, knee-length breeches, leather shoes
Arabian Nights Vizier outfit: silk caftan, turban with jewel, embroidered sash, curved dagger, leather slippers
Achaemenid Persian Satrap outfit: long kandys cloak, belted tunic, tasseled headdress, golden armlets, soft leather boots
Aztec Nobleman outfit: feathered cloak, gold pectoral, beaded loincloth, obsidian-studded sandals, jaguar skin cape