Egyptian Pharaoh outfit: nemes headdress with gold and blue stripes, shendyt kilt with decorative belt, broad collar necklace with lapis lazuli and carnelian, golden arm cuffs, leather sandals with gold trim, crook and flail, false ceremonial beard
Medieval German Emperor outfit: heavy gold crown with fleur-de-lis and arches, brocade tunic embroidered with imperial eagles, fur-lined red velvet cloak with gold trim, gilded leather belt with enameled buckle, chainmail chausses, steel-plated sabatons, ceremonial longsword in scabbard
Ancient Greek Tyrant outfit: white chiton tunic with gold embroidery, purple himation cloak draped over one shoulder, golden wreath with olive leaves, leather sandals with bronze buckles, bronze dagger with ivory grip, heavy gold ring with engraved seal
Byzantine Basileus outfit: jewel-encrusted kamelaukion crown with pearls and cross, loros robe embroidered with gold and religious icons, purple silk tunic with wide golden cuffs, red leather boots with gold buckles, imperial scepter with amethyst gemstone, silk gloves with embroidered crosses
Mughal Emperor outfit: feathered turban with large emerald centerpiece, gold-embroidered angarkha robe, silk churidar pants with floral patterns, bejeweled jutti shoes, jamawar shawl draped over shoulders, multiple gemstone rings, ceremonial dagger with jade handle
Chinese Son of Heaven outfit: golden dragon robe embroidered with clouds and cranes, jade belt with carved ornaments, black silk boots with upturned toes, tall winged mianguan crown with pearl tassels, wide-sleeved inner tunic of red silk, ceremonial ruyi scepter with gold inlay
Ottoman Sultan outfit: grand white turban wrapped with a bejeweled aigrette, gold-threaded kaftan with wide sleeves, silk sash embroidered with floral motifs, loose silk trousers, red leather boots with pointed toes, ceremonial scimitar with gilded hilt, pearl-studded prayer beads
Frankish King outfit: gold-trimmed wool tunic with elaborate patterns, fur-lined mantle fastened with a large brooch, high leather boots with metal buckles, gold-embroidered leather belt with attached coin pouch, crown with fleur-de-lis and cross, longsword with gilded pommel, chainmail coif worn under cloak
Aztec Tlatoani outfit: towering quetzal feather headdress, turquoise pectoral with carved jaguar motif, jaguar pelt cape draped over shoulders, golden armlets and anklets, finely woven cotton loincloth, decorated war sandals, obsidian-bladed macuahuitl sword
Napoleonic Emperor outfit: black bicorne hat with gold braid and cockade, blue and gold embroidered military jacket, white silk breeches with gold side trim, knee-high black leather boots, ceremonial sash of red silk, gilded epaulettes on shoulders, ceremonial rapier with ivory handle
Japanese Shogun outfit: black and gold lamellar cuirass over silk kimono, high wooden geta sandals with fabric straps, tall lacquered kabuto helmet with golden crest, silk obi belt with metal fittings, katana with ray-skin grip in decorative scabbard, war fan with painted sun motif
Persian Shahanshah outfit: silk robe with gold thread patterns of griffins and flowers, golden diadem encrusted with rubies, wide bejeweled belt with scabbard loops, leather boots embroidered with Persian calligraphy, pearl-studded earrings, ceremonial bow inlaid with mother-of-pearl
Mongol Khan outfit: thick fur-lined deel robe with intricate cloud motifs, high leather boots reinforced for riding, fur-trimmed hat with golden emblem, wide silk sash tied around waist, bejeweled dagger with curved blade, iron-tipped horse whip for ceremonial purposes
Zulu King outfit: leopard skin cape draped over shoulders, ostrich feather headband with bone ornaments, beaded necklace with tribal insignia, loincloth of fine cowhide, cowhide sandals reinforced with twine, large ceremonial spear, hardwood shield painted in tribal colors
Mayan Ajaw outfit: massive jade mask covering upper face, tall feathered headdress with quetzal plumes, white cotton mantle with embroidered red patterns, beaded pectoral depicting a sun god, golden armbands, shell-studded sandals, obsidian-bladed ritual knife
Carolingian Emperor outfit: wool tunic with red and gold embroidery, heavy embroidered cloak with fur trim, tall leather boots with bronze buckles, ornate gold belt with small reliquary pouch, golden scepter with enameled decorations, high-peaked crown with crosses
Russian Tsar outfit: Monomakh’s Cap adorned with sable fur and rubies, heavy brocade caftan embroidered with double-headed eagles, fur-lined leather gloves, high leather boots with golden trim, jewel-studded belt with dagger, orb and scepter of gilded silver
Korean Joseon King outfit: red gonryongpo robe embroidered with golden dragons, ikseongwan headdress with jade ornament, silk belt with cloud motifs, finely carved wooden shoes with embroidered soles, wide silk sleeves lined with brocade, jade-studded ring, white inner tunic of fine ramie
Holy Roman Emperor outfit: massive Imperial Crown set with precious gems, heavy purple cloak lined with ermine fur, chainmail hauberk worn under a gold-trimmed surcoat, knee-high leather riding boots, wide ceremonial belt with golden buckle, steel greaves, ornate imperial orb
Hawaiian Ali‘i Nui outfit: vibrant feathered ‘ahu‘ula cloak with red and yellow plumes, crescent-shaped mahiole helmet with curved crest, woven loincloth made of fine kapa cloth, beaded anklets with whale bone charms, wooden spear with shark tooth inlay, large ceremonial paddle staff
Babylonian King outfit: tasseled robe, conical crown, golden armbands, leather sandals, lapis lazuli necklace, ornate scepter
Assyrian Emperor outfit: fringed tunic, bronze-studded belt, tall diadem, embroidered cloak, leather boots, curved dagger
Celtic Chieftain outfit: woolen bracae, fur-lined cape, bronze torc, leather sandals, checkered tunic, iron sword
Roman Emperor outfit: laurel wreath, purple toga, red leather sandals, gold-trimmed tunic, imperial scepter, signet ring
Indian Maharaja outfit: silk achkan, turban with sarpech, churidar pants, embroidered mojari shoes, bejeweled necklace, pearl-studded sash
Hittite King outfit: bronze helmet, knee-length tunic, wide leather belt, golden pectoral, linen trousers, high boots
Gothic Warlord outfit: chainmail hauberk, wolf-fur cloak, iron helmet, leather bracers, wool trousers, spatha sword
Scythian Chieftain outfit: fur-lined leather coat, bronze scale armor, pointed hat, red trousers, leather boots, recurve bow
Achaemenid Persian King outfit: kandys cloak, embroidered tunic, golden torc, high leather boots, elaborate diadem, ceremonial dagger
Macedonian King outfit: bronze cuirass, red chlamys cape, lion-skin headdress, leather sandals, xiphos sword, golden bracers
Hunnic Khan outfit: fur-trimmed deel, high leather boots, silk sash, wolf-head helmet, curved saber, gold-studded belt
Norman Duke outfit: chainmail hauberk, conical helmet, woolen surcoat, leather belt, knee-high boots, kite shield
Renaissance Doge outfit: long crimson robe, corno ducale hat, gold chain necklace, silk gloves, embroidered slippers
Polish-Lithuanian King outfit: kontusz robe, fur-lined żupan, crimson sash, high leather boots, karabela saber
Berber Sultan outfit: white djellaba, blue turban, leather belt, curved dagger, embroidered slippers, silver armbands
Ethiopian Negus outfit: lion’s mane cape, silk shamma robe, beaded crown, wooden staff, golden cross pendant, leather sandals
Khmer God-King outfit: golden headdress, silk sampot, jeweled pectoral, golden armlets, bare feet, ceremonial staff
Tibetan Dalai Lama outfit: saffron robe, wide-brimmed yellow hat, mala bead necklace, woolen shawl, leather boots
Muscovite Grand Prince outfit: fur-trimmed caftan, tall kolpak hat, silk sash, golden pectoral cross, velvet gloves, leather boots
Arab Caliph outfit: long silk thawb, white keffiyeh, golden belt, leather sandals, bejeweled dagger, pearl-studded ring
Andean Sapa Inca outfit: feathered headdress, crimson tunic, golden chestplate, woolen sash, silver bracelets, rawhide sandals
Hebrew King outfit: linen ephod, golden crown, jeweled breastplate, woolen cloak, leather sandals, bronze scepter
Viking Jarl outfit: wolf-fur cloak, iron helmet, mail hauberk, leather boots, thick belt, bearded axe
Bantu Chief outfit: leopard pelt cape, beaded necklace, woven loincloth, brass armbands, carved wooden staff, leather sandals
Caribbean Taino Cacique outfit: feathered headdress, beaded pectoral, cotton loincloth, golden armbands, shell anklets, wooden scepter
French Sun King outfit: powdered wig, gold-embroidered frock coat, lace cravat, silk breeches, buckled shoes, royal scepter
Sikh Maharaja outfit: chainmail kurta, bejeweled dastar turban, silk chola robe, high leather boots, gold-studded belt, talwar sword
Han Dynasty Emperor outfit: black silk robe, dragon-embroidered belt, tall guan hat, cloud-patterned sleeves, jade seal pendant
Cossack Hetman outfit: fur-lined kaftan, zhupan coat, wide sash, red trousers, leather boots, curved shashka sword
Swahili Sultan outfit: long kanzu robe, gold-embroidered cap, silk sash, leather sandals, silver rings, ivory-hilted dagger
Serbian Tsar outfit: golden crown, red embroidered tunic, fur-lined cape, leather boots, silver belt, jeweled cross pendant
Goryeo Dynasty King outfit: royal dragon robe, silk belt, tall black hat, embroidered gloves, wooden shoes, golden seal
Timurid Emperor outfit: embroidered chapan coat, tall fur hat, silk sash, patterned trousers, leather boots, jade-hilted dagger
Haitian Emperor outfit: bicorne hat, gold-trimmed military coat, white breeches, black boots, silk cravat, ceremonial sword
Zulu Chief outfit: feathered headband, leopard skin cape, wooden bracelet, beaded necklace, leather loincloth, cowhide shield