Frankish Crusader Lady outfit: wimple headdress, long woolen gown, embroidered surcoat, leather belt, linen veil, soft leather shoes
Napoleonic Vivandière outfit: shako hat, blue wool jacket, white apron, knee-length skirt, leather boots, canteen
Ancient Greek Amazon outfit: bronze Corinthian helmet, leather breastplate, short chiton tunic, greaves, bow and arrows, leather sandals
Onna-Bugeisha Samurai outfit: silk kimono, armored do-maru cuirass, obi sash, naginata polearm, leather tabi boots
Shieldmaiden Viking Warrior outfit: linen undertunic, wool overdress, leather belt, fur-lined cloak, round shield, sword, brooches
Roman Patrician Lady outfit: stola gown, palla shawl, beaded jewelry, leather sandals, gold hairpins
Mongol Horsewoman outfit: fur-lined deel robe, conical silk hat, wide leather belt, leather boots, composite bow, saber
Byzantine Noblewoman outfit: long silk chiton dress, golden diadem, embroidered cloak, beaded shoes, silver earrings
Persian Warrior Queen outfit: scale armor tunic, tall felt tiara, embroidered silk trousers, curved dagger, cloak
Zulu Warrior Woman outfit: beaded isicoco headband, cowhide skirt, feathered armbands, assegai spear, war shield
Swiss Halberdier’s Wife outfit: embroidered wool bodice, puffed sleeves, linen chemise, pleated skirt, lace bonnet
Hussite Peasant Woman outfit: coif head covering, simple wool dress, leather apron, wooden shoes, beaded necklace
Spanish Conquistadora outfit: morion helmet, puffed-sleeve blouse, leather corset, silk sash, rapier sword, knee-high boots
Carolingian Noblewoman outfit: woolen bliaut dress, embroidered veil, fur-trimmed mantle, soft leather shoes
Celtic Warrior Woman outfit: bronze torc, plaid dress, leather belt, oval shield, war paint, longsword
Gaulish Druidess outfit: linen robe, golden torc, fur-trimmed cloak, ritual sickle, embroidered sandals
Sikh Warrior Woman outfit: blue chola robe, tall dastar turban, steel bracelet, khanda sword, leather sandals
Ottoman Court Lady outfit: silk kaftan robe, jeweled belt, embroidered slippers, pearl earrings, gauzy veil
Teutonic Prioress outfit: black wimple, long wool habit, rosary beads, wooden cross, soft leather shoes
Norman Noblewoman outfit: wimple headdress, fur-lined overdress, silk girdle belt, embroidered cloak, leather shoes
Chinese Ming General’s Wife outfit: high-collared silk robe, beaded headdress, golden sash, embroidered shoes
Scottish Highland Lass outfit: tartan arisaid cloak, fitted bodice, linen chemise, plaid skirt, leather shoes
Aztec Eagle Warrior Priestess outfit: feathered headdress, jaguar pelt cloak, gold jewelry, woven sandals, obsidian dagger
Apache War Woman outfit: beaded buckskin dress, moccasins, eagle feather headband, bone choker, war paint
Hittite High Priestess outfit: bronze diadem, layered linen dress, embroidered sash, golden earrings, sandals
Ethiopian Warrior Queen outfit: lion’s mane headdress, white shamma robe, beaded necklace, curved shotel sword
Arab Mamluk Noblewoman outfit: silk kaftan, embroidered hijab, pearl earrings, golden belt, embroidered slippers
Caribbean Maroon Warrior Woman outfit: conical straw hat, red cotton dress, wooden jewelry, machete, anklet bells
Russian Streltsy Woman outfit: tall fur kokoshnik hat, velvet sarafan dress, embroidered blouse, pearl necklace
French Musketeer’s Companion outfit: feathered cavalier hat, blue velvet bodice, lace-trimmed blouse, silk skirt, knee-high boots
Polish Winged Hussar Lady outfit: crimson kontusz robe, fur-trimmed hat, silk sash, sabretache pouch, riding boots
Tibetan Warrior Nun outfit: red monastic robes, iron lamellar vest, leather boots, prayer beads, straight sword
Genoese Crossbowwoman outfit: steel sallet helmet, padded gambeson, knee-high boots, crossbow, wooden pavise shield
Incan Priestess outfit: gold-studded tunic, feathered headband, llama wool cape, embroidered sash, beaded sandals
Boer Kommando Woman outfit: wide-brimmed hat, leather bandolier, linen dress, sturdy boots, bolt-action rifle
Napoleonic Cuirassier’s Wife outfit: empire-waist silk gown, lace gloves, fur-trimmed cloak, bonnet, embroidered slippers
Berber Desert Warrior Woman outfit: blue turban, wool djellaba robe, leather belt, curved dagger, leather sandals
Spartan Warrior Woman outfit: bronze helmet, red chiton tunic, leather greaves, xiphos sword, round shield
Achaemenid Persian Noblewoman outfit: gold diadem, embroidered silk robe, beaded necklace, leather sandals
Maori Warrior Woman outfit: flax piupiu skirt, ta moko facial tattoos, feathered cloak, greenstone mere club
Japanese Onna-Musha outfit: jingasa helmet, chest cuirass, cotton kimono, war fan, naginata polearm
Zulu War Chief’s Wife outfit: leopard pelt cape, beaded necklace, feathered headband, war shield, sandals
Hawaiian Ali‘i Warrior Queen outfit: feathered mahiole helmet, red pa‘u skirt, wooden shark-tooth club, palm fiber sandals
Tatar Horsewoman outfit: conical iron helmet, silk tunic, quilted armor, fur-lined boots, composite bow, curved saber
Khmer Royal Lady outfit: golden diadem, red silk sampot skirt, embroidered vest, bejeweled necklace, golden anklets
Serbian Hussar’s Lady outfit: fur kalpak hat, crimson silk jacket, pearl earrings, knee-high boots, embroidered belt
Gothic Tribal Warrior Woman outfit: steel spangenhelm, fur-trimmed tunic, wooden round shield, seax dagger, spear
Dacian Priestess outfit: wolfskin headdress, linen tunic, golden torc, bronze greaves, dagger
Hunnic Noblewoman outfit: fur-trimmed deel robe, leather boots, golden earrings, braided hair, beaded necklace
Moro Warrior Queen outfit: silk sarong, turbanned headwrap, loose trousers, kris dagger, bejeweled sandals