Egyptian Queen outfit: vulture crown, pleated linen dress, wide collar necklace, golden armbands, beaded sandals, kohl-lined eyes
Medieval German Empress outfit: embroidered bliaut gown, golden circlet, fur-lined mantle, silk veil, leather shoes, gemstone brooch
Ancient Greek Queen outfit: peplos, golden diadem, leather sandals, bronze fibula, pearl earrings, embroidered sash
Byzantine Empress outfit: pearl-studded stemma crown, purple silk loros, embroidered stola, jeweled belt, red leather shoes
Mughal Empress outfit: peshwaz gown, dupatta veil, churidar leggings, embroidered jutti shoes, bejeweled nose ring, gold bangles
Chinese Empress outfit: phoenix crown, dragon-embroidered robe, silk sash, pearl hairpins, golden bracelets, embroidered slippers
Ottoman Haseki Sultan outfit: jewel-embroidered kaftan, silk şalvar pants, golden belt, embroidered veil, pearl earrings, velvet slippers
Frankish Queen outfit: woolen bliaut, fur-lined cloak, golden fillet, leather belt, silk wimple, leather shoes
Aztec Cihuatlatoani outfit: feathered headdress, cotton huipil tunic, gold-studded pectoral, beaded earrings, turquoise sandals
Napoleonic Empress outfit: empire-waist gown, pearl tiara, lace gloves, embroidered shawl, silk slippers, cameo brooch
Japanese Empress outfit: junihitoe robes, tall lacquered hat, silk obi sash, geta sandals, folding fan, hair combs
Persian Shahbanu outfit: silk robe, diadem crown, wide belt, gold-studded sandals, pearl necklace, embroidered veil
Mongol Khatun outfit: deel robe, tall boghtaq headdress, fur-lined boots, silk sash, jade earrings, curved dagger
Zulu Queen outfit: beaded headdress, cowhide skirt, brass bangles, feathered collar, woven belt, leather sandals
Mayan Queen outfit: jade-studded huipil, feathered headpiece, beaded pectoral, golden anklets, cotton sash, shell earrings
Carolingian Empress outfit: woolen dress, gold diadem, fur-trimmed mantle, embroidered wimple, leather belt, linen veil
Russian Tsarina outfit: kokoshniki headdress, gold-brocade sarafan, pearl necklace, silk shawl, leather boots, silver earrings
Korean Queen Consort outfit: royal red jeogori, dragon-embroidered chima skirt, jade binyeo hairpin, silk beoseon socks, embroidered shoes
Holy Roman Empress outfit: golden crown, silk surcoat, fur-lined mantle, jeweled brooch, leather shoes, pearl necklace
Hawaiian Ali‘i Wahine outfit: feathered cloak, crescent-shaped necklace, woven sarong, shell anklets, beaded bracelets, wooden spear
Babylonian Queen outfit: fringed wool dress, golden diadem, beaded pectoral, embroidered sandals, lapis lazuli bracelet
Assyrian Queen outfit: linen tunic, tall jeweled crown, wide gold belt, pearl earrings, fur-lined cloak, leather sandals
Celtic Chieftainess outfit: plaid tunic, bronze torc, fur-trimmed cloak, embroidered belt, leather shoes, iron dagger
Roman Empress outfit: stola, gold fibula brooch, leather sandals, pearl earrings, palla shawl, laurel wreath
Indian Rani outfit: silk lehenga choli, jeweled tikka headpiece, golden anklets, embroidered dupatta, silver bangles
Hittite Queen outfit: fringed wool dress, conical hat, golden necklace, wide belt, beaded sandals
Gothic Warrior Queen outfit: chainmail tunic, fur-lined cloak, leather greaves, iron torc, thick belt, longsword
Scythian Warrior Queen outfit: fur-lined coat, leather trousers, bronze bracers, feathered cap, curved bow
Achaemenid Persian Queen outfit: embroidered kandys robe, gold diadem, pearl-studded necklace, silk sash, leather sandals
Macedonian Queen outfit: pleated chiton, golden fillet, leather sandals, jeweled earrings, woolen himation
Hunnic Noblewoman outfit: fur-trimmed deel, beaded necklace, golden torc, silk sash, embroidered boots
Norman Duchess outfit: silk bliaut, linen wimple, embroidered veil, golden belt, leather shoes, pearl necklace
Venetian Dogaressa outfit: brocade gown, lace veil, jeweled necklace, embroidered gloves, silk slippers
Polish-Lithuanian Queen outfit: kontusz robe, fur-trimmed żupan, pearl-studded belt, golden earrings, red leather shoes
Berber Queen outfit: blue tagelmust veil, embroidered kaftan, silver bangles, beaded earrings, leather slippers
Ethiopian Empress outfit: lion’s mane cape, silk shamma dress, beaded crown, golden cross pendant, silver anklets
Khmer Queen outfit: golden headdress, silk sampot, jeweled pectoral, pearl bracelets, gold sandals
Tibetan Noblewoman outfit: silk chuba robe, coral-studded headdress, beaded necklaces, woolen shawl, leather boots
Muscovite Grand Princess outfit: fur-lined caftan, tall kokoshnik, silk gloves, pearl necklace, leather boots
Arab Calipha outfit: long silk abaya, embroidered hijab, gold earrings, jeweled belt, silk slippers
Andean Queen outfit: crimson tunic, golden headdress, beaded pectoral, woolen sash, leather sandals
Hebrew Queen outfit: embroidered linen dress, golden crown, jeweled breastplate, leather sandals, bronze bracelet
Viking Shieldmaiden outfit: wool tunic, fur cloak, leather boots, bronze brooch, iron sword
Bantu Queen outfit: leopard pelt cape, beaded necklace, woven loincloth, brass armbands, carved wooden staff
Caribbean Taino Chieftess outfit: feathered headdress, beaded pectoral, cotton dress, golden armbands, shell anklets
French Queen outfit: powdered wig, lace-trimmed gown, silk gloves, pearl necklace, embroidered slippers
Sikh Rani outfit: silk chola robe, embroidered shawl, gold-studded belt, pearl earrings, velvet slippers
Han Dynasty Empress outfit: phoenix diadem, dragon-embroidered robe, jade belt, silk gloves, embroidered slippers
Cossack Hetwoman outfit: fur-lined zhupan, tall velvet hat, pearl earrings, silk sash, leather boots
Swahili Queen outfit: long kanzu dress, gold-embroidered cap, beaded necklace, leather sandals, silver rings
Serbian Tsarina outfit: golden crown, red embroidered dress, fur-lined mantle, pearl necklace, silk shoes
Goryeo Dynasty Queen outfit: royal dragon robe, silk belt, tall binyeo hairpin, embroidered shoes, jade pendant
Timurid Princess outfit: embroidered chapan coat, fur-trimmed hat, silk sash, pearl necklace, silver earrings
Haitian Empress outfit: bejeweled tiara, gold-embroidered gown, silk gloves, pearl earrings, heeled shoes
Zulu Warrior Queen outfit: feathered headdress, leather skirt, beaded armbands, brass bangles, cowhide shield