Casual Female Outfit: Floral Sundress, Sandals, Straw Hat
Business Female Outfit: Black Blazer, Pencil Skirt, Ivory Silk Blouse, Nude Pumps
Athletic Female Outfit: Sports Bra, Leggings, Athletic Shoes
Party-Ready Female Outfit: Sequined Top, Black Skinny Jeans, High Heels
Beach Female Outfit: Flowy Cover-up, Bikini, Straw Beach Bag
Formal Female Outfit: Floor-Length Evening Gown, Statement Necklace, Elegant Heels
Winter Female Outfit: Turtleneck Sweater Dress, Faux Fur Coat, Thick Tights, Knee-High Boots
Vintage Female Outfit: A-line Dress with Polka Dots, Cat-Eye Sunglasses, Vintage Heels
Hipster Female Outfit: Oversized Cardigan, Graphic Crop Top, High-Waisted Shorts, Ankle Boots
Chic Female Outfit: Striped Breton Top, High-waisted Culottes, Block Heel Sandals
Relaxed Female Outfit: Oversized Sweater, Leggings, White Canvas Sneakers
Urban Female Outfit: Denim Jacket, Black Ripped Jeans, Studded Ankle Boots
Preppy Female Outfit: Cable Knit Sweater, Plaid Skirt, Knee-high Socks, Mary Jane Flats
Edgy Female Outfit: Faux Leather Jacket, Ripped Fishnet Tights, Platform Boots
Classic Female Outfit: A-line Midi Skirt, Silk Blouse, Pointed-toe Pumps
Boho Female Outfit: Flowy Maxi Dress, Beaded Sandals, Floppy Wide-brim Hat
Casual Streetwear Female Outfit: Camouflage Jacket, Boyfriend Jeans, Platform Sneakers
Modern Business Female Outfit: Turtleneck Sweater, Tailored Trousers, Block Heel Pumps
Sporty Female Outfit: Sports Crop Top, Leggings with Mesh Panels, Athletic Sneakers
Effortlessly Cool Female Outfit: Leather Moto Jacket, Distressed Boyfriend Jeans, Ankle Booties
Casual Bohemian Female Outfit: Off-the-shoulder Top, Flowy Skirt, Gladiator Sandals
Modern Vintage Female Outfit: Retro Blouse, A-line Skirt, T-strap Mary Jane Shoes
Casual Smart Female Outfit: Blazer, Printed Blouse, Tailored Shorts, Block Heel Mules
Artsy Female Outfit: Colorful Print Dress, Artsy Pendant Necklace, Artistic Flats
Casual Athleisure Female Outfit: Athleisure Dress, Baseball Cap, Sneaker Wedges
Business Casual Female Outfit: Blouse, Tapered Trousers, Block Heel Pumps
Romantic Female Outfit: Floral Wrap Dress, Straw Sun Hat, Wedge Sandals
Grunge Female Outfit: Oversized Denim Jacket, Fishnet Tights, Platform Creepers
Modern Preppy Female Outfit: Striped Sweater, A-line Skirt, Ballet Flats
Laid-back City Female Outfit: Oversized T-shirt Dress, Canvas Slip-on Sneakers
Weekend Gardener Female Outfit: Utility Jumpsuit, Wide-brim Hat, Garden Clogs
Casual Dog Walker Female Outfit: Sleeveless Top, Leggings, Slip-on Shoes
Barbecue Party Host Female Outfit: Cold-shoulder Top, White Jeans, Wedge Sandals
Neighborhood Block Party Female Outfit: Sundress, Straw Clutch, Espadrille Flats
Athlete Female Outfit: Racerback Sports Bra, Yoga Leggings, Running Hat
Book Club Female Outfit: Knit Sweater, Flowy Skirt, Ballerina Flats
Jogger Female Outfit: Tank Top, Leggings with Reflective Stripes, Running Sneakers
Concert-goer Female Outfit: Cropped Graphic Tank, Denim Shorts, Converse Sneakers
Farm Worker Female Outfit: Chambray Button-up Shirt, Denim Overalls, Rubber Boots
Rancher Female Outfit: Fringe Leather Jacket, Denim Skirt, Cowgirl Boots
Country Music Festival Female Outfit: Boho Sundress, Suede Fringe Vest, Cowboy Boots
Outdoor Explorer Female Outfit: Performance Tank Top, Convertible Pants, Trail Shoes
Biker Female Outfit: Moto Jacket, Skinny Jeans, Studded Biker Boots
Countryside Picnic Female Outfit: Gingham Dress, Straw Sun Hat, Sandals
Craftsman Female Outfit: Artist Smock, Jeans, Comfortable Sneakers
Wedding Female Outfit: Flowy Maxi Dress, Flower Crown, Wedge Sandals
Farm Market Female Outfit: Off-the-shoulder Top, High-waisted Skirt, Woven Flats
Rural Fair Female Outfit: Ruffled Blouse, Denim Shorts, Embroidered Sandals
Cowgirl Female Outfit: Floral Western Dress, Cowgirl Hat, Cowgirl Boots
Mountain Hiker Female Outfit: Technical Tank Top, Convertible Hiking Pants, Hiking Boots
Horseback Rider Female Outfit: English Riding Helmet, Show Jacket, Jodhpurs, Riding Boots
Summer Carnival Female Outfit: Crop Top, Denim Skirt, Flat Sandals
Bluegrass Festival Female Outfit: Boho Romper, Fringe Vest, Cowboy Boots
Rodeo Attendee Female Outfit: Western Graphic Tank, Denim Shorts, Cowgirl Boots
Outdoor Wedding Female Outfit: Midi Floral Dress, Strappy Sandals, Sun Hat
Vineyard Picnic Female Outfit: Flowy Sundress, Wide-brim Hat, Sandals
Country Fair Female Outfit: Cropped Blouse, High-waisted Skirt, Ankle Boots
Hip-hop Street Style Female Outfit: Crop Top, Jogger Pants, Timberland Boots, Chunky Gold Necklace
Urban Artist Female Outfit: Artist Smock Dress, Canvas Sneakers, Beret
Streetwear Enthusiast Female Outfit: Cropped Puffer Jacket, Cargo Pants, Platform Sneakers
Cyberpunk Female Outfit: Cyberpunk Hooded Dress, LED Platform Boots, Goggles
Vintage Urban Female Outfit: Polka Dot Swing Dress, Cat-Eye Sunglasses, Vintage Heels
City Bohemian Female Outfit: Boho Maxi Dress, Fringed Shawl, Leather Sandals
Business Casual Urban Female Outfit: Wrap Blouse, Tailored Culottes, Block Heel Mules
Minimalist Female Outfit: Oversized White Shirt, Straight-leg Pants, Minimalist Sneakers
Surfer Female Outfit: Tie-dye Crop Top, Denim Shorts, Birkenstock Sandals
City Runner Female Outfit: Running Tank Top, Running Leggings, Athletic Sneakers
Goth Female Outfit: Velvet Dress, Choker Necklace, Combat Boots
Biker Female Outfit: Moto Jacket, Ripped Skinny Jeans, Studded Biker Boots
Skyscraper Office Female Outfit: Pencil Skirt, Silk Blouse, Classic Pumps, Tote Bag
Tech Enthusiast Female Outfit: Techwear Hoodie, Reflective Leggings, High-tech Sneakers
City Music Festival Female Outfit: Boho Kimono, Fringed Shorts, Ankle Boots, Flower Crown
Rocker Female Outfit: Stud-embellished Leather Jacket, Graphic Tee Dress, Chunky Platform Boots
Professional Female Outfit: Sheath Dress, Blazer, Pumps, Structured Handbag
Dancer Female Outfit: Crop Top, High-waisted Dance Leggings, Jazz Shoes
Yoga Enthusiast Female Outfit: Racerback Yoga Bra, High-waisted Yoga Leggings, Yoga Mat Sling
City Commuter Female Outfit: Trench Coat, Striped Top, Skinny Jeans, Ballet Flats
City College Student Female Outfit: Oversized Sweater, Leggings, Canvas Sneakers, Backpack
Executive CEO Female Outfit: Power Suit ,Blazer, Trousers/Skirt, Button-down Blouse, Heeled Pumps
Chef Female Outfit: Chef's Jacket, Checkered Pants, Chef's Hat, Non-slip Kitchen Shoes
Doctor Female Outfit: White Lab Coat, Medical Scrubs, Stethoscope, Comfortable Shoes
Firefighter Female Outfit: Firefighter Turnout Gear ,Jacket, Pants, Fire Helmet, Fire Boots
Lawyer Female Outfit: Tailored Suit, Blouse, Statement Necklace, Closed-toe Pumps
Police Officer Female Outfit: Police Uniform ,Shirt, Pants, Duty Belt, Police Cap, Police Boots
Nurse Female Outfit: Medical Scrubs, Comfortable Shoes, Stethoscope, ID Badge
Flight Attendant Female Outfit: Flight Attendant Uniform ,Blazer, Blouse, Skirt, Scarf, Cabin Crew Shoes
IT Professional Female Outfit: Business Casual Attire ,Blouse, Dress Pants/Skirt, Dress Shoes,
Architect Female Outfit: Architectural-inspired Outfit:, Modern Blouse, Pencil Skirt, Heeled Sandals
Engineer Female Outfit: Engineer's Work Shirt, Work Pants, Steel-toed Boots, Safety Glasses
Teacher Female Outfit: Blouse, A-line Skirt, Cardigan, Flats
Photographer Female Outfit: Casual Professional Attire ,Blouse, Jeans, Casual Shoes,
Fashion Designer Female Outfit: Edgy Designer Outfit:, Asymmetrical Dress, Bold Heels
Real Estate Agent Female Outfit: Professional Attire ,Blazer, Blouse, Pencil Skirt, Heeled Pumps,
Electrician Female Outfit: Work Coveralls, Work Boots, Safety Gloves, Hard Hat
Marketing Specialist Female Outfit: Stylish Business Casual Attire ,Blouse, Tapered Trousers, Heels,
Sales Representative Female Outfit: Professional Business Attire ,Blouse, Pencil Skirt, Heeled Pumps,
Veterinarian Female Outfit: Veterinarian Scrubs, Lab Coat, Stethoscope, Comfortable Shoes
Journalist Female Outfit: Casual Professional Attire ,Blouse, Pencil Skirt, Heeled Ankle Boots,